WWWWGGGGWWGMGGGMMMGG
WWGWWWWGGWWGWGGMMGGW
GGWWWWWGGWWGWGMMGGGW
GGGWWGGWWWWWGGGMMGWW
WGWWGMMGWWWWGGMMMMGW
GGWWGGGGWGWGMMGMGMMG
MMGGWWGWGGWGMGGGMGGM
MMGGWWGWGGWGGMMGMMGG
GMMGWGGGGGWGGGGWGMGM
WGMMGMGGMGWGGGMGGGGM
