GFMGFWGFFFWWWGWGFGWFWWWWGWWWFFGGDDRGGDDDGDDDDGWWWG
WWGDGFMGFGWWWFWGFWFMGGGGDGGWWGMRRRRDDDDGDDDDGWWGGD
GWWGFGGFGWWWWWGGWGMMMGWWGWWGFMMRGMMGGGDGGDDGGWGDDD
DGGFFGGGGWFFFFFFGWFFGFWGGFWGGFMRMMGWGGDDDGGDGWWGDD
DGWWWWGMGGFGWWGFGWFFFWGGFWGWWGFRGMGGMMGGGDDDDGWGDD
GFGFFWWFWWGMGWGWWFGGGWWWWFWWGDRRMHMMMGGMGDGGGWWGDD
WWWWWGFFFWWFGFMGWGGWWFWGGWWFWRRDGMGGMMMMMGMMGWGDDD
WFGGFWFGFGFGGFGWGDGGWWFWWWGGFRDDDGGMGGGGMGGGGWWGDD
GWWGMGWGFFMGGWWGDDDGFGFGFFFFMRDDDDGMGMGMGWWWWGGGDD
WWFMGGGMFFFWGFFFGGGFFMFGMFWWGRGDDDGFGMMGMGWWWGDDDD
FFGGFMMFGFGFWFFFMMFFGMMMHMFWFRWGGGGMFGGGMGWWWWGDDD
WGFFWGFWWGMMFFWGGGFMFMFGMGGWGRGFGWFFGGMGMGWGGGDDDD
FFGGFGGGGMFFFFFWWGGGMFMMMFFWGRGWGWWWGGMMMMGMGDDDDD
WGGWFMMGFFGGMGGWFMFFGGMMFGGWFRMFWFWWWGGGGGGMGDDDDD
WFGGFGFMGMGFMMGGGMGGGMFMFFWWSRMGWGGWGGGMMGMHMGDDGD
WWFFGFWGGGFGGFGFMHMGFGMMMGGGGRMGWGGFWFGGMMHHHMGGMG
WGWWFWWFWFFGGFMGGMHMFWFGFFFGFRMMFWGFWFMGGGMMMMGGMM
WFGWGFWWFMGWWFMMGFMGMFWWFMGFWRMMFWWWWFFMFMMGGMGGMM
FFWWFGFFGMGFWFMFGFGWGWFFMGGMGRFGWWFGFFFFFFMGMMMMMG
FWWFGFGFWGMGWWFGFWWGWWWWGDDGMRSWWFWFWWWWFMMGMGMHMM
FFGWWFGGWFFFFFMGWGWWFGWFFGGGFRGWFFWWWWWFWGFGGMHMGM
WWGGWFWWGMGGFWGMGMGGGFWGFWFMFRGGWFFWGFFFGMFMMGMGMG
WWWWWWFGGGWFFWFGFMFWGWFGWGGFWRMFWGWGFWWFWFMHMGGMHM
WFFWFFFMGFWGFGFWFGWGWWGGGGFMFRMFWFWGFWFWGGGMGMMHHH
GFGWGFMFFGWFFWWWWWFGFWWWWFGGMRGGWWWWGGFWWGMGWGMHHH
MMFGDGFWWWFFMGGWWFFWGWWWFWGFMRFMGFFWWFWFGMGWGMHHHH
GMMMGGMFWFFFFGMFFGFFGGWFFWFGFRWFFWWWWGGWGMGWWGMMHH
GGMMFWFWFWGGMMFWGFGFFFGWGGGMGRFGGGWWFMMGMHMGWGMGMH
WFFMGFFWGGWFMGFWGWGFGFMFWFWGMRFFWWFGMMMGMHHMGDGDGM
WFFMMFWGFWFGMMFFWFWGFWFGGWWWFRFWWGGGGGGMMHHHMGMGMM
FWGMMGWWGWFGGGWFWFWFWWGFFGWGSRWGGMFFGWGMGMMHMGMMGG
FGWGGFFFMFMFFMGFGMFWWWWWWFFWSRFWFFFGFWWGFGGMGMHHMM
WWGMMFGFMFGMMHMMMFWGGGWFGGMFSRGWWWWFMFGFWWGGGMHMGG
GGGFFFWGMFFFMHHHHMFGGMFWFMMMFRWFFGFFMFFWGGMMMGMGWG
MGMMFMFGMGWFMHHHHHMGMFGFWFFMFRGFMMFMFFFGGFGGFGMMFF
MMHHMGMMMFFFMHHHHHMGFGMFWGGGFRMMMFFFMFGMGMGGWWFFGW
FMHHHMHHHMMMMMHHHHMGGGMMGGMMMRMGMGFGMFGMGFGWFWGGGW
MHHHHHHHHMGGFGMHHHHMGGFGMMHHHRGGGWWGFWWGWFMFMFFWGF
GMHHHHHHMFGFWFFMHHHHMFGMHHHHHRDDDGGMGWFMFGFFFGWFMF
GMHMHHHHHMFMFMMHHHHHHMMHHHHHHRDDGWGFFWFMGMMMMGWFFW
MFMGMHHHHHMHMHHHHHHHHHHHHHHHMRGGWFFMMFMGMMFGGMFWGG
FFMGMHHHHHHHHHHHHHHHMHHHHHHHMRSWWWFMFMFGMFGMMFWWFF
MMMGMHHHHMMHHHHHMMHMGMHHHHHHHRSGFGGGWFFWGMGFGFGWWG
FGGMHHHMMFFMMHHMGFMGWGMHHHHHMRSFMFWWWFGFFFMMFGMFWG
FMGMHMMFFMFGFMMFFGGMFMFMHHHHHRGMFMGWGFGFMFGGWWFWFM
FMMFMFGGGFWGWFFWFFWFGFGMHHHHHRMFGFWFMMMFFWWFFGGGWF
GGGMGWGWFWFGFMMGFGFFFGGMHHMHMRFMGWFFFGFGGGWGFFGMGF
GFGGFFFGWFFFMMMFGFMGMMGFMMGMGRGFGWWWFWGFWWFMGFMMGW
GFWGFWWGGFMMMGFWFMHMFGFMGGWGGRGMGGWGFWWFWFWGGMGGGW
FWGGGWWWGMHHHMMGMHHHMFMGFMFFFRFGMMGFWFFFWGWFGGDGWW
WWWWGWGGWFMHMFFGMHHHHMFGWFWFFRSWGGGMGMFWFFGFFWGDGG
FWWWWWFWGGMHHMMGFMHHHMGWFWWWGRGWWGGMFMFWWGMFMFMGGD
FFWWWWGWGMHHHHHMMHHHHMFGWFFGMRSWGMMMMFGWFWFGFMMFMG
MFWFFFWGMHHHHHHHHHHHMFFFWFGMGRFWFFMFMGMGGFMFFMMGFM
HMFGFFFMHHHHHHHMHHHMHMMGWFWFGRSWFFFMMMMGWFGFWGMGWF
MHMFGWGMHHHHHHMFMHMGMGGWFGGMFRGFWFGFGGMFWWWWGFGGFF
GMMMMGWGMHHHHHMFMHMFGMFFGMMHMRSWFGWFGGFWGFFFGWWWWW
WGGGFMGMHHHHMMHMHHMGFFFWGFMMGRFFFMFFWWWGMGFWGGFWFF
FWWWGMMHHHHMFFMHHHMFMGWGFGGMMRFMMGMGWFGGFMMFWGGWWW
FWFFMHHHHHHHMGMHHHHMGWWFWGMMGRFFGGMGGMFGFMMMFGGGWG
WFWFFMHHHHHHMGMHHHHHMFFFWWFGGRGFWWFWWFMFGFFMMFWWGM
FFFWFFMHMHHMGFMHHHHMHMFGFFGWGRGFGFWFGGGGMGFFGGGFFM
WFMGMFMMFMMHMMHHHHMGMGMFFGFGMRMFMMGMMMFFGDGMGDGFGG
GMFFMGMFMGFMFMHHHMGMGFMGWFMMHRMGMMGGFGWGGGFGMGGFMM
GFMFGGMMHMMHMMMHHHMFGMGMFMMFMRGMGMMMFFWWFWWGGDDGMG
MMMGGGFMHHHHMGFMHHMGGFMFMGGMHRGMMGMGGWWFGFWGDGGDGD
HMFFFGMHHHHHMGFFMMFFGFFMHMMHHRGMMGMGGWFFMFGDDDDDDD
HMGGMGMHHHHHMGFGGGFFWWFMHHHHHRMMGMMGGWWWGGDDDDDDDD
MGFMHMHHHHHMGWGWWFWFWFMHHHMMHRGMMGMGMGFFGWGDDDDDGD
MFMGMHHHHHMFWWGFWWFFWGGMHMGGMRMGGGMGMMGGGWWGDDGGWG
HMMFFMMHHHMFGWFFWGWWFWGMMFFFGRMMGMGMMMGWWWWGDGWWWG
HHHMGGFMHHMGWFGFWFFWFFGMFWWGGRMMGMGGGMGGGGWGGMGGWW
HHMMGMGMHHMGGFWWWFFFMMFMFFWGWRFFGMMMMGWWWWWWWGWWWW
HMGFGFWFMHHMFWGWGFFFMMMMFFWFGRSWGMHHHMGWWGWGGWWWWW
HHMGGWWGMHMMGGWWFWFGFGGFWWGMMRSGWGMMMGWGGGWGMGGGWG
HHHMMGWFMMFGWWWFGFMGGFWWGWWFMRSGWGMGGWWWWGWGMGWWWG
HHHHMFFFGGWWFWWWWGMGMFGFMGGFFRSWGWGMGWWWWWGGGGWGGW
HHMMMFMFGGWFWFGWFFMFFGMGMGFFSRSWWWWGWWWWWWGWWWWGWW
HMGGGFFMMFWFGGGWWFGMMFFFGFGGSRSWWWWWWWWWGGWWGGGWWW
MGMFWFMMGFFGWWFGWGMGGWWFWWWFFRSWWWWWWWWGWWWGWWWWWW
MFMGFWGGWFWWGWFGWFFGGFWGFFWGMRSWWWWWWWWWGWGWWWWWWW
GFFMGFWGGWWFFWWWWGGFGMGFMGGGGRSWWWWWWWGGWWWWWWWWWW
WFFGGWWGFGGMGFWWFWWWWFFMFWGWFRSWWWWWWWWWWWWWGWWWWW
FGWWFWFWWFGMMGFWWFGWGWFMMGWWFRSWWWWWWWWWWWWWWWWWWW
GGWWWWFWFMGGGGFFWFFFGGFGFGFGMRSWWWWWWWWWWWWWWWWWWW
FGWWFWFFMFFFWWFGFGGGMFMFFFGWFRSWWWWWWWWWWGWWWWWWWW
WWWFMFMGMFWWFWWFWGFGMFGFGWGWFRSWWWWWWWWWWWWWWWWWWW
GGGFMGFGFMFWGWWGGGWGMMMGMFFGMRSWWWWWWWWWWWWWWWWWWW
FWFFMFMFWGGGFWFFWFWWGMMGMFGGMRSWWWWWWWWWWWWWWWWWWW
MFWGFWGGGMGWGGMGGMGGGGFWFFWFFRSWWWWWWWWWWWWWWWWWWW
GMFFFFGWGMMGFWGMMFMMMMMFMMFWGRSWWWWWWWWWWWWWWWWWWW
GFMGWFWFGMGGFGGFMFGMGGMGMGWWGRSWWWWWWWWWWWWWWWWWWW
WGMFWGGGMMGFMMGMHMMMGGGWFGFWGRSWWWWWWWWWWWWWWWWWWW
WFGGWGGFMGMMGMGGMMGFWFWGFGFFFRSWWWWWWWWWWWWWWWWWWW
GMMGWFFFMFFFGFGFGGFGWWFWGGWWGRSWWWWWWWWWWWWWWWWWWW
MFGMFFGGFMFFGFMFFMMGWGWWGGGFGRFWWGWWWWWWWWWWWWWWWW
GGMFGMFFFFMFWFFFWGMGGGWGGGFFMRSWWWWWWWWWWWWWWWWWWW
MMGFMFFMMGGFGGWWGWFWWFFMFWWGFRSWWWWWWWWWWWWWWWWWWW
GFGMFGFGFFGWWWGWWWGGGWFGGFWGMRSWWWWWWWWWWWWWWWGWWW
WGGGFGWWWGFWGFGFFFMMGWGDGGGGGRFWWWWWWWWWWWWWWWWWFG
